1111111
1000001
10C01C1
100P001
1C00101
1000E01
1111111