111111111111111111
1E0000000C00000C01
101001010010001001
101001001010101001
1P0000000C00C000C1
111111111111111111