111111111111111
1000C10000C1111
100101011111111
101001000000C11
1C0000010000011
1111010100010E1
111001111111111
100000010001111
1P100000C1000C1
111111111111111