111111111111111
1P10000000000E1
111000000000001
1000C00000C0001
111111111111101
100000000000001
100000000000001
100000000000001
1C00000000000C1
111111111111111