111111111111111
100011000011111
100101011111111
101001000000111
110001010000011
111101010001111
100101000000011
101000010001111
1P1000001100011
111111111111111