111111111111111
1P20000000000C1
100000000000111
1000C00000C00E1
100000000000001
100001101000001
100000100000001
100000100000001
1C0000100c000C1
111111111111111