111111111111111
1000C10000C1111
100101011111111
101001000000C11
1C0001010000011
1111010100011E1
111111111111111
101000010001111
1P100000C1000C1
111111111111111