111111111111111
1P00000000001E1
100000000000111
1000C00000C0001
100000000000001
100001101000001
100000100000001
100000100000001
1C0000100c000C1
111111111111111