111111111111111
1P00000000000C1
100000000000111
1000C00000C00E1
100000000000001
100001101200001
100000100000001
100000100000001
1C00001000000C1
111111111111111