111111111111111
1C0000000000011
101111111111111
1011111111111E1
100000000000001
100001101000001
100000100000001
100000100000011
1000001000000P1
111111111111111