1111111111
1CCCCCC0E1
1000000001
10C0C0C0C1
1P100000C1
1111111111